{
  "id": "m1",
  "name": "Village Start",
  "width": 15,
  "height": 10,
  "layers": [
    {
      "name": "Ground",
      "data": [
        0, 0, 0, 0, 0, 0, 0, 0, 0, 0, 0, 0, 0, 0, 0,
        0, 0, 0, 0, 0, 0, 0, 0, 0, 0, 0, 0, 0, 0, 0,
        0, 0, 0, 0, 0, 0, 0, 0, 0, 0, 0, 0, 0, 0, 0,
        1, 1, 1, 1, 1, 1, 1, 1, 1, 1, 1, 1, 1, 1, 1,
        1, 1, 1, 1, 1, 1, 1, 1, 1, 1, 1, 1, 1, 1, 1,
        0, 0, 0, 0, 0, 0, 0, 0, 0, 0, 0, 0, 0, 0, 0,
        0, 0, 0, 0, 0, 0, 0, 0, 0, 0, 0, 0, 0, 0, 0,
        0, 0, 0, 0, 0, 0, 0, 0, 0, 0, 0, 0, 0, 0, 0,
        0, 0, 0, 0, 0, 0, 0, 0, 0, 0, 0, 0, 0, 0, 0,
        0, 0, 0, 0, 0, 0, 0, 0, 0, 0, 0, 0, 0, 0, 0
      ]
    },
    {
      "name": "Objects",
      "data": [
        4, 4, 4, 4, 4, 4, 4, 4, 4, 4, 4, 4, 4, 4, 4,
        4, -1, -1, -1, -1, -1, -1, -1, -1, -1, -1, -1, -1, -1, 4,
        4, -1, 2, 2, 2, -1, -1, -1, -1, -1, -1, -1, -1, -1, 4,
        -1, -1, 2, -1, 2, -1, -1, -1, -1, -1, -1, -1, -1, -1, -1,
        -1, -1, 2, -1, 2, -1, -1, -1, -1, -1, -1, -1, -1, -1, -1,
        4, -1, 2, 2, 2, -1, -1, -1, -1, -1, -1, -1, -1, -1, 4,
        4, -1, -1, -1, -1, -1, -1, -1, 3, 3, 3, -1, -1, -1, 4,
        4, -1, -1, -1, -1, -1, -1, -1, 3, 3, 3, -1, -1, -1, 4,
        4, -1, -1, -1, -1, -1, -1, -1, -1, -1, -1, -1, -1, -1, 4,
        4, 4, 4, 4, 4, 4, 4, 4, 4, 4, 4, 4, 4, 4, 4
      ]
    }
  ]
}
