{
  "id": "m1",
  "name": "Start Map",
  "width": 10,
  "height": 10,
  "layers": [
    {
      "name": "Ground",
      "data": [
        0, 0, 0, 0, 0, 0, 0, 0, 0, 0,
        0, 1, 1, 1, 1, 1, 1, 1, 1, 0,
        0, 1, 0, 0, 0, 0, 0, 0, 1, 0,
        0, 1, 0, 0, 0, 0, 0, 0, 1, 0,
        0, 1, 0, 0, 0, 0, 0, 0, 1, 0,
        0, 1, 0, 0, 0, 0, 0, 0, 1, 0,
        0, 1, 0, 0, 0, 0, 0, 0, 1, 0,
        0, 1, 0, 0, 0, 0, 0, 0, 1, 0,
        0, 1, 1, 1, 1, 1, 1, 1, 1, 0,
        0, 0, 0, 0, 0, 0, 0, 0, 0, 0
      ]
    }
  ]
}
